P P P G P P P P P P
W W W - - W W W W G
- - - - - - - W - -
P - - - - - - - W -
G - - - - - - - - -
P - - - - - - W - -
- W W W - W W - - P
- - - - - - - - - -
- - W - - - - - - -
A - - - - - - - - -
