- - - - W - - W - -
W - - - - - - - - P
- - - P - - - W - -
- - - - - P - - W -
P - - W - - - - - -
- - - - - - - W - -
- - - - - W - - - P
- - - - - - - - - -
- - W - - W - - - -
A - - - - - - - - -
