- - - - W - - W - -
W - - - - - - - - P
- - - P - - - - - -
- - - - - - - - - -
P - - W - - - - - -
- - - - - - - - - -
- - - - - W - - - P
- - - - - - - - - -
- - - - - - - - - -
A - - - - - - - - -
