- - - - W - - W - -
W - - - - - - - - P
- - - P - - - - - -
- - - - - P - - W -
P - - W - - - - - -
- - - - - - - - - -
- - - - - W - - - P
- - - - - - - - - -
- - W - - - - - - -
A - - - - - - - - -
